15 15 25
3 3 W 0 W 0 1 0 0 2 1 W 6 W W 
1 0 3 0 0 W 0 0 0 0 W 2 W 0 0 
0 0 0 1 0 2 0 0 0 2 W W 1 0 W 
0 0 0 1 0 0 M 2 0 2 0 0 0 0 W 
W W 1 W W 3 2 0 0 0 0 3 0 0 W 
W 0 0 W W 0 1 2 W 2 3 0 2 3 W 
W 0 W 3 W 3 0 W 0 W W W W W 0 
3 0 0 3 0 2 W 5 6 W 3 0 5 9 7 
1 0 0 2 2 0 W W W 0 W 1 8 2 W 
W 3 0 3 3 2 W 0 0 0 W W W W 3 
W 0 0 2 0 0 0 0 0 W W 0 1 0 0 
W W W 0 1 1 W 0 0 3 0 0 0 W 0 
0 W 0 0 M W W 0 0 1 2 0 2 W W 
0 W 0 0 0 1 0 3 3 0 0 0 W 9 9 
3 0 0 0 0 W W W W 2 3 1 W 2 0 
