11 13 20
1 4 W 0 0 0 0 0 0 W W 0 W
6 W 0 0 0 0 0 0 W 1 W W 3
W 0 M 0 0 0 0 0 W 2 3 W 1
0 0 0 0 0 0 0 0 0 W 1 W 2
0 0 0 0 0 0 0 0 0 0 W W 5
0 0 0 0 0 0 0 0 0 0 0 0 W
0 W W W 0 0 0 0 0 0 W W 2
0 W 1 W 0 0 0 0 0 W 1 0 1
0 W W W 0 0 0 0 0 W 1 0 4
W W 0 0 0 0 W 0 0 W 0 W 6
8 W 0 0 0 W M 0 0 W 1 1 W