15 15 25
0 0 0 W 1 0 0 0 0 0 1 W 0 0 0
0 W 1 W W W 0 W W W W W 0 W 0
0 W 0 0 0 0 0 0 0 0 1 0 0 W 0
0 W W W 0 W W W W W W W 0 W 0
0 0 0 W 0 1 0 W 0 0 0 0 1 W 0
W W 1 W W W 0 W W W W W W W 3
M W 0 W 1 0 0 W 0 0 0 0 0 W 0
0 W 0 W W W 0 W 0 W W W 0 W W
0 0 0 W 0 0 1 W 0 W 0 W 1 0 0
W W W W 0 W W W 0 W 0 W W W 0
0 0 0 0 0 0 0 0 1 W 0 0 0 0 0
0 W W W W W W W W W W W 0 W W
0 0 0 0 0 0 0 0 0 0 1 W 0 W M
W W 0 W W W W W W W 0 W 0 W 0
0 3 0 W 1 1 0 1 0 0 0 W 1 0 0