12 12 20
1 4 W 0 0 1 0 0 0 W W 0
6 W 0 0 0 0 0 0 W 4 W W
W 0 0 3 0 0 0 0 W 5 5 W
0 0 0 0 0 0 0 0 0 W 6 W
1 0 1 0 0 0 0 0 0 0 W W
0 0 0 0 2 0 0 1 0 0 W 0
0 0 0 0 0 0 0 2 0 0 0 0
M 0 0 0 0 0 1 0 0 0 1 0
0 0 1 0 0 2 0 3 0 0 1 0
0 0 0 0 0 0 0 0 0 W W W
0 0 0 0 0 0 0 0 1 W 1 1
1 0 0 0 0 1 M 0 0 W 1 2