15 15 50
2 8 4 4 0 3 W 0 0 0 W W 1 2 0
9 1 8 0 8 0 W 0 3 0 W 1 3 0 0
W W 2 6 9 W W 0 0 0 0 0 0 0 0
1 0 W 5 W 0 0 0 0 0 1 0 0 0 0
M W W W 0 3 0 0 0 2 W W 3 0 W
3 0 0 W 0 0 0 0 0 0 W W 0 W 9
1 0 3 2 W 0 W W 0 1 2 3 M W 0
0 0 1 0 0 0 W 0 0 0 1 3 3 W 0
W W W W W 0 3 0 0 0 W W W 3 0
1 0 9 W 0 3 2 0 0 2 W 8 0 1 W
1 0 W W 1 1 W 0 W 0 1 W 6 W 0
0 W 0 0 W 0 W 0 W 2 0 0 W W 0
7 W W 0 0 0 0 2 0 0 3 0 W 0 0
W 0 3 0 3 0 1 0 0 W 0 0 0 1 0
0 2 0 0 1 W 3 1 0 0 2 1 0 3 2
