15 15 50
1 1 0 W 1 1 0 1 W 0 1 1 0 1 0
1 0 W 2 0 1 W W 0 0 0 1 W 0 0
0 3 W 3 1 W W W M 0 2 W 0 W 0
3 0 0 W 0 0 0 0 0 M 1 W 0 W 1
2 3 W W W 1 3 3 0 0 W 4 0 2 W
3 W 0 0 2 0 W 1 2 W 5 W 6 5 0
2 W 0 0 2 2 W 0 1 W W 0 W 0 4
W 3 0 0 0 1 W 0 3 W W 0 0 W W
0 W W W W W W 0 0 W 1 3 3 0 0
W 0 W 6 W W W 0 3 0 1 0 W 0 0
W 0 0 W 0 0 2 W 0 0 0 0 0 1 0
0 W 2 1 0 0 0 0 0 0 0 W W W 3
W 3 1 1 2 0 0 W 0 0 3 W 5 0 W
W 0 0 0 0 0 W 0 1 W W 8 5 9 3
0 0 2 3 0 0 W W W 0 1 5 0 6 0
