15 15 50
3 0 W 0 2 3 0 0 W 0 3 4 W W 5
6 0 8 W W 0 0 W 0 6 6 W 0 1 W
2 W W W W W 2 W 3 1 3 W W 3 0
W 3 0 3 3 1 0 3 W 1 W 0 0 M 1
W 0 0 0 2 0 2 0 0 W 0 2 1 0 0
W 0 2 0 W W W 0 W W W 2 0 0 3
2 0 0 0 0 W W 0 2 1 2 0 W 1 0
0 0 0 W W W W 2 0 0 2 2 0 W 0
0 0 3 1 3 0 0 0 0 3 2 W W 5 W
0 0 0 0 0 0 0 3 0 0 0 W W W 0
0 0 W 2 W 0 0 0 0 W 0 0 2 0 W
W 0 W W W 0 2 0 W 0 0 2 0 1 W
3 3 W 2 W W 0 0 W W 0 0 0 0 W
0 1 0 0 0 0 1 W 9 0 W M W 2 0
0 0 W 0 0 0 W 2 0 0 W 0 W 0 0
