15 15 50
1 1 3 1 W 0 0 1 W 0 W W 0 0 2
0 0 0 W 1 0 0 0 M 0 0 0 0 0 0
3 0 0 0 0 1 0 2 0 0 0 1 0 W W
3 0 2 0 0 0 0 1 3 W 0 0 0 W W
1 W W 0 0 W W 2 2 2 0 0 3 W 0
2 3 W W W W W W 3 0 0 0 1 1 0
0 0 0 0 W 0 0 W 0 0 0 2 2 0 0
0 0 0 2 W 0 0 0 0 0 W 0 0 0 W
W W 0 W 0 0 0 W 0 3 W W W 0 W
0 0 0 0 0 0 0 0 0 W W W 0 W 7
1 2 W W 0 0 W 0 2 0 0 0 W 6 1
0 0 W 0 W 0 0 2 3 0 0 0 W 5 0
0 0 W 1 0 W 0 0 2 M 1 0 0 W 0
0 0 W 0 5 W 0 W W 0 W 2 0 W 5
0 W 0 7 0 0 W 0 0 0 0 0 0 W 7
