15 15 50
W 0 2 3 W W 0 0 0 0 0 0 0 W 0
0 0 0 W 0 W 0 0 0 3 3 0 0 W 0
0 W 3 W W W 0 0 0 0 0 2 0 0 M
W W 2 2 0 W 0 0 W W 2 0 W W W
0 W 0 0 2 0 0 0 W 0 W 0 0 W W
2 0 3 2 2 0 3 0 W W 0 0 0 0 0
0 0 W 0 M 0 0 0 W 8 W W 0 0 3
W 0 0 0 0 W 0 0 W W W W W 0 0
W 0 0 0 W W 2 0 0 0 2 0 W W 3
3 W 0 W 0 0 0 1 0 0 0 0 W 0 0
6 W 0 0 0 0 3 1 W 0 0 2 W W 2
7 5 W 0 0 0 0 2 2 3 W W W 3 W
W 7 W 0 0 0 3 0 2 0 3 0 0 0 W
0 W 0 0 W W W 3 0 0 0 2 0 3 W
0 3 0 0 W 4 1 W 2 0 0 0 W W 7
