15 10 50
W 2 W 1 0 0 0 0 0 0
W 0 0 0 0 0 0 0 0 3
1 W 0 0 3 W 1 0 0 W
7 3 W 0 0 0 0 0 W 6
5 0 W 0 0 0 2 0 W W
0 3 W 0 W W 0 3 0 3
5 2 W W 6 W 0 0 0 0
3 W 0 W W 2 0 0 0 0
1 W 0 1 0 0 0 M W 0
M W 0 W 0 0 0 0 0 0
W 0 0 3 1 1 2 W 0 0
0 W 0 1 0 2 0 0 0 2
3 W 3 0 1 0 0 W 0 0
W 0 0 0 0 1 0 0 W W
1 W 0 W W W 0 0 0 W
