15 15 50
0 W 0 1 W 1 W 0 W 0 0 7 9 9 1
0 W 0 0 W 6 W 3 0 W 3 2 4 1 6
0 W 3 0 W W W W 2 W 0 W W 8 0
1 8 W 0 W 0 0 W 0 W W 0 3 W W
9 W 2 1 0 0 0 W 0 0 0 M 0 W 0
0 W 0 W 0 1 2 0 0 0 0 W 0 0 0
W W 2 0 3 W 0 W 2 3 3 0 W W W
0 1 0 0 2 W W 0 0 W W 0 0 0 W
0 1 0 0 0 W 3 0 0 0 0 1 0 W 7
W W 1 3 W 7 W W 0 0 0 1 1 W 5
7 W 0 0 W 7 W 0 0 0 1 W 0 3 W
W 2 0 0 W 2 2 W 0 1 1 W 0 0 0
W 0 0 1 W 6 W W 3 0 0 0 0 3 W
W 0 0 1 0 W 0 W W 0 0 1 0 W 1
W 0 W 0 2 0 0 W W 0 0 W M W 8
