15 15 50
7 W 3 1 W W 0 0 2 W 0 W 2 W 2
W 3 M 3 W 0 W 3 2 W 0 W 0 W 0
0 1 0 2 0 W 0 0 W 6 5 W 0 W W
1 0 1 1 0 0 0 0 W W W W 0 0 1
W 3 W 0 1 0 0 0 0 0 0 1 0 3 2
0 0 0 2 W 0 0 0 W 0 0 0 0 0 W
0 M 0 W 0 W 0 1 0 3 3 1 0 0 0
0 0 0 2 W W 3 0 0 0 W 0 0 1 0
0 2 3 3 0 0 1 0 0 W W 1 0 3 0
0 0 W 0 0 0 1 1 1 0 0 0 1 W W
0 2 W 0 0 2 0 0 0 W W 0 0 W 0
0 0 0 W 0 0 W W 0 W 0 0 0 W 2
W W 0 W W W 2 W 0 0 0 0 1 W 7
9 W 0 W 0 7 4 6 W W W W 0 0 W
0 W 0 2 W 1 3 4 3 5 5 W 0 0 W
