15 15 100
W M 1 0 W 0 0 0 2 0 1 W 6 W 7 
0 W 1 1 2 0 0 W W 3 0 W W 0 W 
1 W 0 0 W 0 0 W 0 2 0 0 2 1 0 
0 W 2 2 W 0 W W 0 0 1 0 0 2 0 
W 0 3 W 0 0 W W W 0 W W W 0 0 
0 0 0 W W 0 W 0 0 3 0 W 0 W 1 
0 0 2 0 0 2 1 2 0 0 M 0 2 W W 
0 1 2 0 3 2 0 0 W W 0 3 1 W 9 
W W 0 0 0 0 0 0 W W W 0 W 0 0 
0 W 0 0 W 1 0 0 0 0 W 3 W W W 
4 W 0 0 W 0 W 2 0 0 3 0 0 0 1 
3 6 W W 0 0 W 0 3 2 0 0 3 3 W 
W W W W 0 0 3 W 0 3 2 0 0 1 W 
2 0 0 0 0 W W 0 W W W 0 3 W 2 
W W 0 1 0 W 0 3 4 4 W 0 0 W 8 
