14 13 50
0 3 0 0 W 4 W 3 W 0 0 0 0 
2 0 1 3 W 6 W 2 W 0 0 0 W 
0 0 W W 0 W 0 0 0 0 0 0 0 
0 0 0 W W 3 0 W W 1 0 0 0 
2 0 W W W 0 0 W W 3 0 3 W 
0 0 0 0 0 0 W 3 1 W M 0 1 
2 3 0 W W 0 W 0 0 W 3 2 2 
0 0 W 0 4 W 1 4 3 7 W 0 W 
0 2 W 9 W W W 1 W W W 2 W 
0 0 0 W 0 3 2 W 2 0 0 0 W 
0 M 0 0 1 0 0 W W 0 0 0 W 
0 0 0 0 2 2 W W W W 2 0 0 
0 3 0 0 2 0 W 3 0 0 0 2 0 
0 0 0 2 0 0 0 0 2 W 0 0 W 
