11 13 50
2 0 2 0 0 0 3 W W 0 7 6 4
0 0 W 1 1 W 2 0 0 W 0 W 0
W W 0 0 0 0 0 0 0 W W 0 W
0 2 0 0 0 0 3 3 0 3 0 0 0
M 0 0 3 1 0 0 W W 1 M 3 W
3 0 0 0 W W 0 W 2 W 2 W 6
W W W W 8 W 0 W 1 W 0 0 W
W W W W W 0 0 W W 3 0 2 0
0 2 0 0 0 0 W 2 1 W 0 0 3
0 0 0 0 0 0 2 W 3 7 W 3 W
0 W 0 W W 0 0 W 4 0 W 0 W
