15 12 50
W W 0 0 W M 0 0 0 0 0 W 
3 0 0 0 0 2 0 0 0 W 1 2 
W 3 0 0 0 0 0 3 W 0 0 2 
0 2 0 2 0 W 0 W W 0 W 0 
0 2 0 0 0 3 0 W 0 0 W 0 
2 0 0 3 0 3 0 0 0 W W W 
1 0 0 W W 0 3 0 M W 0 0 
0 W W 3 W W 3 W 1 0 0 0 
0 1 W W 0 0 0 W W W 0 0 
W 0 1 1 1 0 W 1 W 2 0 0 
W 0 0 W 2 0 0 W W W 3 0 
W W 0 0 0 3 0 0 0 3 W 0 
0 0 0 0 W 0 W 0 0 1 2 0 
W W W W 2 W W W 0 0 0 0 
6 8 0 0 6 W 0 0 0 0 1 0 
