14 14 50
5 W 0 2 0 W 0 1 0 0 W 0 W 0 
0 W 0 M 0 W 0 0 0 0 0 0 W 0 
W 1 0 1 2 0 0 0 1 2 W W 0 W 
W 0 W 2 0 0 0 0 0 0 0 W 0 0 
W 2 W M W 0 0 W 0 0 1 0 0 0 
0 0 0 W W 0 0 0 0 0 3 0 0 0 
2 1 1 W 0 0 0 0 0 0 0 W W 1 
0 W 1 0 0 0 0 0 W W W 1 W 0 
2 W W W 0 0 0 0 W 4 W W W 0 
W 1 7 5 W 2 3 0 W W 0 0 3 2 
7 W W 0 7 W 0 1 2 0 0 2 0 0 
W 2 0 W 0 W 0 W 0 W W 0 2 0 
W 2 0 W W W 0 W W W W 0 1 3 
1 0 1 2 1 0 0 0 0 0 0 3 0 W 
