15 15 50
6 9 W 0 0 0 0 0 2 0 1 W 5 0 6
2 8 W W 0 W W 0 0 0 2 0 W 4 4
W W 3 3 0 W W 0 W W 0 0 0 W 0
3 2 0 2 W 0 0 0 3 0 0 0 M W 9
0 2 0 0 W W 0 W W W 0 W 0 W W
0 0 2 W 0 W 0 W 8 9 W 0 1 0 1
3 0 W 0 2 6 W 5 2 8 W 0 0 0 W
W W W W W W 5 0 0 0 W 0 0 2 W
1 W 0 0 2 0 W 9 W W W 0 1 0 W
0 0 0 0 1 M W W 1 0 0 0 0 1 2
0 W W 1 W 0 0 3 0 1 1 0 0 0 0
0 W 2 0 0 0 0 2 3 0 0 0 W W W
0 0 0 2 0 0 0 0 0 0 3 W 0 9 7
W 0 0 0 3 2 0 W 0 0 0 W 3 1 0
0 0 0 0 1 0 0 0 1 0 0 2 W 6 6
