15 15 50
0 W 0 0 0 0 0 0 3 0 W W 0 3 3
W W W 3 0 2 0 0 W 0 0 0 0 0 M
0 0 0 0 W W W W W 3 0 0 2 0 2
0 0 0 0 W 0 W 0 W 0 0 0 2 0 0
W W 0 0 W W 0 0 W 0 0 0 0 W W
7 6 W 3 0 1 0 2 0 0 W W 1 W 4
2 W 0 3 0 0 W W W W 6 W 0 W 2
4 W 3 0 W W 9 9 3 3 1 W 0 3 W
7 2 W 0 W 5 2 W W W W W W 2 W
W W 0 W 0 5 W 0 0 1 0 0 0 1 0
0 0 W W W W 0 0 W 3 2 0 0 0 0
1 0 0 0 0 2 0 0 3 2 3 0 W 1 1
2 0 W W 3 0 M 0 2 0 0 W W 0 2
0 0 0 W W W 0 W 3 0 0 W 0 0 2
0 W W W 0 2 0 0 0 0 0 0 W W W
