15 15 50
0 W W 0 0 W 3 0 0 0 0 3 0 0 0
0 0 0 0 M W 0 0 1 0 0 0 1 0 W
0 W W 0 3 3 0 0 2 0 0 W W 0 W
0 3 W 2 0 0 1 0 0 3 W 0 0 W 0
0 0 0 W W W W 0 0 0 0 0 0 W W
W 0 0 0 W 6 W 0 W 0 1 W 3 3 3
W 0 W W 6 0 W 0 1 W W W W 0 1
6 W 6 0 0 W 0 1 W 8 W 0 2 2 W
0 3 1 9 9 7 W 1 0 W W 0 0 3 2
7 5 5 7 0 W 0 0 0 0 0 0 0 0 W
8 2 W W 4 W 0 0 0 0 W W 2 2 W
5 W 0 0 W W 0 3 2 0 0 0 2 0 3
6 W 3 2 3 W W W 3 0 3 W W 0 W
4 9 W M 1 0 0 2 1 0 W 4 W 2 W
0 8 8 W W 0 2 0 W W 0 5 7 W 7
