15 13 50
7 W 3 0 W 0 0 M 0 3 0 W 2
7 W 0 0 0 0 W W 3 W 0 W 0
5 W 0 0 0 W 9 W 0 2 0 W 6
0 W 0 0 W 8 1 W 0 0 0 0 W
2 W 0 W 1 W W W W 2 0 1 0
W 0 2 W W 2 0 0 2 0 0 W W
0 0 W 5 W 0 0 0 1 W 3 M W
W W 8 1 9 W 3 0 1 2 0 0 0
W W W W 2 W 2 0 0 0 0 3 1
1 1 0 1 W 5 W W W W 0 0 3
0 1 1 0 W W 0 0 0 1 0 1 3
0 1 W 0 0 0 0 W 0 0 0 0 0
0 1 0 0 0 0 0 W 0 0 1 0 0
W 0 0 W W W 0 3 0 0 0 0 W
W 1 0 W 2 0 W 0 0 3 W W 6
