12 11 50
6 W 3 0 0 M 3 0 W 6 8 
W 2 2 W 0 1 W 0 W 2 7 
4 W W W 0 3 0 W W 3 M 
W 2 1 W 0 0 0 W 2 W 3 
W 3 0 0 0 2 0 W 0 0 W 
W 0 0 1 W 0 0 0 0 3 0 
4 W 0 0 0 0 0 2 0 3 1 
2 W 0 3 1 0 W W 0 2 0 
W 2 0 0 0 2 1 3 W W 3 
0 0 3 2 0 0 W W W 7 W 
W W W W W 0 0 0 2 W 2 
7 3 8 3 8 W 0 0 0 W 0 
