10 15 50
0 M 1 1 0 2 W W 0 W W W W 4 W
2 1 0 2 3 0 0 0 W 3 0 3 0 W 0
0 0 0 0 0 W 0 1 0 0 0 0 1 0 3
0 0 0 2 0 0 3 W W W W 0 0 2 0
0 0 0 0 0 0 2 2 3 W 5 W 0 0 M
0 0 0 0 0 3 0 0 3 W W 2 0 W W
0 W 3 0 0 0 0 0 0 0 0 0 2 0 0
2 1 0 0 0 0 2 0 W W W 0 0 W 0
0 0 0 3 W W W 0 W W 0 0 0 W W
0 0 3 0 W 1 W 0 W 0 W 2 3 0 0
