11 15 50
0 2 6 7 W 0 0 0 0 0 0 0 0 1 W 
7 5 W W 3 0 0 0 0 W 3 0 0 W 6 
0 W 3 2 0 3 0 0 W 0 W W W W W 
W 0 0 0 0 0 0 0 W W W W 0 1 M 
W 0 0 1 2 2 0 0 3 0 0 0 3 0 3 
W 0 0 0 0 W W 0 1 0 0 0 W 0 0 
2 3 0 1 W 6 0 W 3 3 W 1 W 2 W 
0 3 0 W 4 2 0 4 W 2 0 W W 2 0 
W 0 0 1 W 0 6 W W 2 0 0 W M 1 
W 0 0 W 3 7 W 0 0 0 W 0 W 0 0 
W 0 0 W 0 0 8 W W W W 0 0 1 0 
