15 14 50
W 0 W 1 0 0 W 0 W 0 0 W 2 0
0 2 1 3 0 0 0 3 1 0 0 0 W W
3 0 0 3 0 W W 1 3 1 2 1 1 0
2 0 0 W 0 3 0 0 W W 0 0 3 0
3 0 0 W W 3 3 0 2 1 2 0 0 0
0 0 0 0 0 0 3 2 0 0 1 W W W
0 0 0 0 1 0 3 0 0 3 1 W 2 3
0 0 M 0 W 1 0 0 0 0 W 5 0 5
W 0 W 0 0 0 0 0 2 0 W 8 2 0
3 3 1 1 W 0 3 0 2 2 1 W 6 0
3 1 W W 1 W 0 3 0 0 0 W 4 0
0 0 0 0 W W 0 3 2 0 W W 0 1
1 3 0 W W W W 0 3 0 W 0 W 3
0 0 0 3 0 3 3 3 W 3 0 3 M W
0 0 0 1 2 0 3 2 3 W W 2 3 0
