13 11 50
0 4 W 0 0 3 3 0 0 0 0 
W W 0 0 0 M 3 0 0 W W 
3 W 3 0 0 0 0 1 0 1 0 
0 0 0 0 W W W 3 0 2 3 
2 2 0 0 W W W 3 0 W W 
2 0 0 0 0 0 2 0 0 W 1 
0 0 0 0 0 W 3 W 0 W W 
W 1 0 0 3 M 0 0 0 0 0 
1 0 0 0 0 0 0 0 W W W 
0 0 2 3 0 W 0 W 0 6 3 
3 0 W W W W 3 W W W W 
W W 3 1 W 3 0 W 2 2 2 
1 5 0 4 1 W 0 0 0 0 0 
