15 15 50
5 7 0 0 W 0 0 0 0 1 1 3 W 0 1
0 2 2 W 0 M 0 0 0 0 0 W 0 2 W
7 W 4 2 W W 0 W W 0 2 0 W W 0
W 2 W 0 W 0 0 W W 0 W 0 3 2 3
0 0 W W 1 0 0 0 0 2 0 3 0 1 0
2 0 2 W 2 0 2 W W 0 0 0 0 W 0
2 W 3 0 0 0 0 0 W 0 0 3 3 W 0
0 0 1 0 0 W 0 2 W 1 W 0 0 1 0
0 0 0 0 0 0 1 1 0 1 0 3 0 1 0
1 0 W 0 0 0 3 W W W 0 0 3 W W
W W 0 W 0 0 0 0 0 0 0 W W 4 6
0 0 W W 0 0 0 0 2 0 0 0 0 W 2
2 0 2 2 2 W W 0 2 0 2 0 0 W 9
0 0 0 0 W 4 3 W 0 0 W 0 W 0 0
1 0 M W 0 7 0 W 0 3 W W 0 1 0
