12 14 50
5 2 2 0 W W 2 0 W 0 W 8 0 4
2 W W W 0 W 1 0 0 0 0 W 0 0
W 0 2 3 0 0 0 0 0 0 W W 1 W
0 W 2 W 2 0 0 W 1 W 0 0 W 1
9 W W 3 W W 0 0 2 0 0 0 0 0
W 1 0 2 0 W 0 0 1 0 0 0 0 0
W 1 0 0 0 0 2 0 0 W 0 1 0 0
1 0 0 0 0 0 0 W 2 0 0 0 1 W
0 0 0 W 0 0 3 0 0 W 1 0 0 0
0 0 M 0 0 0 0 0 W 0 W W 0 2
3 M 0 0 0 1 3 0 0 W 0 0 0 W
W 3 W W W W 0 0 2 W W 2 0 W
