14 12 50
3 7 W 1 0 M W 0 0 0 2 W
3 W 3 2 0 W W W 0 0 0 W
5 W 0 0 0 0 0 3 0 0 0 W
8 W 2 0 3 1 0 0 0 1 W 4
3 W W 1 3 0 0 W 0 0 W 5
W 0 0 0 0 0 0 W 0 0 0 W
0 0 0 0 0 W 2 W W 0 0 1
0 0 2 0 1 W 0 0 0 0 3 W
W 3 0 0 0 W 0 0 3 0 0 3
W 0 0 0 W 0 W W 2 0 M 0
1 2 W 0 W W 0 0 2 0 0 W
0 3 W 0 0 0 0 1 W W 3 0
0 0 W W W W W W W 0 0 0
0 W 1 9 4 0 9 W 1 0 0 W