15 15 50
0 8 0 W 0 0 0 0 0 W 0 8 0 8 2
5 9 W 0 0 0 0 0 0 0 W W W 5 0
W W W 0 0 3 0 0 0 W 0 0 0 W 9
0 0 0 0 W W W M 3 0 2 2 3 W W
W W W W 6 0 4 W 0 0 3 0 0 W 0
3 W 6 5 6 0 W 0 0 0 2 M 1 1 0
W 0 W 7 W 9 W 0 0 W 0 0 1 3 0
W 0 W W 0 W W 0 3 3 0 W 0 0 0
0 2 0 W 2 0 3 0 0 0 1 0 0 0 3
0 0 0 0 1 0 0 W 0 W W W 0 0 0
W W W 0 0 W W 1 1 0 W W 1 0 0
0 0 0 2 W 5 W 0 0 1 1 W W W W
W W 0 0 0 W 2 0 W W 0 W W W W
0 W 0 0 0 3 0 0 W 0 0 0 3 0 0
2 W 0 2 1 0 W 0 0 1 W 1 0 0 W
