14 15 50
0 3 0 W 1 0 0 0 W W 0 0 3 W W
0 0 0 2 0 0 2 W W 3 0 W 0 0 0
0 0 3 W 0 3 0 W 0 0 0 W 1 0 0
0 0 M W 0 0 0 3 3 W 0 2 W 0 0
0 0 0 W 0 0 3 0 0 W W 0 0 0 0
0 0 0 W W W 0 W 0 W 8 W W 1 1
0 0 0 W W 1 0 0 3 W 0 6 7 W W
2 3 3 W 2 0 W W 2 0 W W W 0 W
0 0 0 0 0 0 0 2 0 W W 0 2 2 0
W W W W 1 W W W 0 1 0 2 0 0 W
W W W W W W 2 0 1 0 0 0 0 0 W
0 3 0 2 0 2 0 0 0 0 1 W 0 W 3
0 3 0 M 0 0 W 1 W W 0 2 0 W 7
W 0 W W 0 0 0 0 W 0 1 W 0 W 0
