15 15 50
3 W 0 W 0 0 2 0 0 W 7 0 5 8 W
W 1 0 0 W 0 1 W W 0 2 W W W 3
W 2 0 0 0 0 W 9 5 W W 1 3 3 0
0 3 2 0 M 2 W 7 W 0 2 W W 0 0
W W 3 0 1 2 W 7 W 3 W W W 1 W
0 0 0 W W 0 W W 0 0 0 0 0 0 0
0 0 W 8 W 1 1 0 0 0 M 0 1 0 2
2 2 0 W 5 W 0 0 0 0 W 1 0 0 0
W W 0 W 1 6 W 0 0 0 W 1 3 2 W
0 0 0 W W W 0 W W 3 0 3 W W 0
W 3 1 0 0 W 0 0 W W W 0 W W W
W 0 0 0 0 W 1 3 0 W 2 0 0 3 3
W 0 3 3 0 W 0 0 2 W W W 0 W 2
W 3 3 0 2 0 0 W 0 W 4 0 W 0 0
5 W W 0 0 0 W W 0 W 2 5 W 0 0
