13 11 50
0 M W W W W 2 3 0 1 0
W 0 0 0 3 0 W W W 3 0
0 3 0 0 W 3 3 0 0 1 0
2 0 0 0 0 3 0 3 0 0 0
3 3 2 3 0 0 W 0 3 W W
0 2 0 0 0 0 W W W W 4
0 2 3 W W W 4 W 0 0 W
W 0 W 3 W 2 W W W 2 0
W 2 0 0 1 W 0 1 3 0 0
0 0 0 0 1 0 0 0 0 3 0
2 0 0 0 0 W W 0 0 0 0
0 3 0 0 0 W 0 W W 0 W
W 0 M 1 3 W 0 4 0 W 6
