13 15 50
0 W W 3 W 0 0 W 0 5 1 9 7 W W
0 1 2 0 W 0 0 W W W W 6 W 2 0
0 3 0 0 0 1 W W 0 0 0 W 1 1 M
2 0 3 W W W W W 3 W W W 0 0 W
0 0 1 M W W 0 3 0 1 0 0 0 0 0
0 2 0 0 2 0 2 0 0 0 0 0 0 2 0
W 0 0 0 W W W 0 0 0 1 0 0 0 0
5 W W 1 W 0 0 3 2 0 0 0 0 2 W
W W 1 0 3 0 W 0 2 0 W W 0 1 0
0 W W 0 W W 9 W 3 2 W W 0 0 0
0 W 0 1 0 0 W 8 W 0 0 W W W 3
2 0 0 0 W 0 W W W 0 W 4 0 W 0
W 0 W 2 W 0 3 0 0 0 W 8 W 0 0
