15 15 100
1 0 0 3 W 0 W 0 3 2 0 0 0 W 0 
3 1 2 2 0 0 2 0 W 1 0 2 0 2 W 
0 1 2 2 0 0 W W W W 3 0 0 2 W 
2 0 0 2 0 0 W W 1 0 1 0 0 3 0 
W 0 1 W W W 1 2 0 0 0 W W 3 0 
0 0 0 W W 0 0 2 2 0 0 W 7 W W 
W 0 0 W W 1 3 2 0 3 W W 0 5 9 
W 0 0 3 2 2 0 W W 2 0 3 W W 0 
W 0 2 0 3 1 3 W M W 0 0 0 3 W 
W 3 0 0 W 0 0 W 6 W 1 0 0 1 W 
5 W W 1 2 0 0 W 6 W 2 2 1 W 6 
3 0 W 0 0 1 0 W 2 0 W 0 0 W 1 
0 3 W 0 2 0 0 W 0 3 0 W W 6 3 
7 5 W 1 1 2 3 W 1 2 6 9 9 3 3 
3 0 W 0 0 W W 9 6 7 4 M 0 1 0 
