15 15 50
W 2 2 0 W W 0 1 2 1 0 3 0 0 2
W 3 0 0 W W 0 W 3 0 1 0 0 0 1
0 W 3 0 0 W 0 1 0 0 0 0 0 3 0
W 0 0 0 1 0 0 0 W W 0 W 0 W W
6 W W W 0 0 0 3 W W 3 1 0 0 W
1 W 0 0 0 2 0 0 0 0 2 1 0 0 W
7 8 W 0 W W 2 0 0 0 0 0 0 1 W
9 W W 0 0 3 0 0 0 1 0 W W W 5
W 2 0 0 0 M 0 0 W W 0 0 3 W 9
W 0 W W 0 0 0 2 W W 1 1 W W 2
0 0 2 2 0 M 0 0 W W 1 W W 0 W
0 0 0 1 2 2 0 0 0 W 0 W 2 0 3
0 1 W W 0 0 2 W 0 0 0 3 0 0 W
0 1 W W 0 0 1 0 0 0 0 1 0 W 9
W W 6 W 3 1 0 0 2 2 0 W W 4 2
